########
#@.*.*.#
#.$$$$.#
#.*.*..#
########