#######
#@$..*#
#.....#
#.$..*#
#######
---
11,15