 ######
##.@*##
#..$$.#
#..*.##
######