#########
#@..*...#
#.$.$.*.#
##$###$##
#.$*$.*#
#.......#
#########
---
45,55