########
#@.*.*.#
#.$$$$.#
#.*.*..#
########
---
29,38