#######
#..*..#
#.$*$.#
#..@..#
#######
---
11,15