#######
#     #
#@$.* #
#     #
#######
---
2,3