#######
#@....#
#.$##.#
#.$...#
#.$##*#
#..**.#
#######
---
35,45