#########
#.......#
#.......#
#@$ $ $ #
#...***.#
#########