#######
#..*..#
#.$*$.#
#@$$$.#
#..*..#
#######
---
16,25