#######
#.....#
#.@$*.#
##.##.#
#..$..#
#..*..#
#######
---
23,30